1 1 1 0 0 1 1 1 1 1 1 1
0 2 1 1 1 2 2 0 0 2 1 2
5 4 0 0 2 1 1 1 2 0 0 4
1 1 2 1 1 1 5 0 5 1 2 1
2 1 1 2 0 0 3 2 2 3 0 0
6 0 0 1 2 2 1 0 2 2 0 1
4 1 1 5 0 0 6 0 0 1 1 0
2 0 0 2 1 1 2 0 1 2 1 1

3 5 5 3 4 0 0 1 2 2 1 0
2 1 0 0 5 4 4 5 0 0 1 2
0 5 5 5 6 0 0 0 0 0 4 4
5 3 4 4 3 0 6 0 2 2 1 0
5 5 0 0 4 4 0 0 1 5 1 0
2 2 2 2 1 0 4 4 4 0 0 1
4 0 0 4 2 2 0 0 5 5 6 0 
5 4 4 0 5 0 6 3 3 0 0 1
3 5 5 3 4 0 0 1 2 2 1 0
9 9 9 9 9 9 9 9 9 9 9 9